env: 2
---
■─────────────■
│.............║
│.............║
│C.E...T.....S║
│.............║
│.............║
■═════════════■