env: 2
filler: 0|1|2|0
filler: 1|12|6|0
---
┌───────╖ ┌─────╖
│.......║ │T.T.T║
│.......X─X.....║
│..E.....1....S.║
│.......X═X.....║
│.......║ │T.T.T║
╘═══════╝ ╘═════╝