env: 2
---
■──────────────────■
│......■.....T..T■.║
│.■..■........T....║
│.■...■...T.....■.T║
│E■..........T..T.S║
│.■....■........■.T║
│.■...■■..T.......■║
│...T..■........T..║
■══════════════════■