XXXXXXXXXXXXXXXXXXXXXXXXXX
X...X..X...TX....X..X....X
X...X.......X........X...X
X...X..X.........X....X..X
X......XTX..T..XXX..T..X.X
XE..T..XTX..T..XT..TTT.SXX
X........X.....XXX..T..X.X
X...X.......X..X......X..X
X...X....X..X........X...X
X...X....X..X..X....X....X
XXXXXXXXXXXXXXXXXXXXXXXXXX