env: 2
---
XXXXXXXXXXXXXXXXXXXXXX..XX
X...........X.......TXXX.X
X......XXX..X....X...X...X
X...X....T..X...XTX..X.TTX
X...X....T.XX....X.....TTX
X...X...ET.....X.........X
X...X....T.XX.XTX....XXX.X
X...X....T..X..X.....X...X
X...X..XXX..X........X.STX
X...........X..........TTX
XXXXXXXXXXXXXXXXXXXXXXXXXX