env: 1
name: Level 7 - So close
filler: 5|3|2|0
---
┌──────────╖
│......T#B#║
│.■■■■.■###║
│....■■..TT║
│...TTT...T║
│...TETST..║
│.■...TTT■.║
│.■.■■■....║
│.■...■.■..║
│.......■..║
╘══════════╝