env: 1
filler: 3|3|2|180
filler: 1|11|1|0
---
■────────────■
│....T.......║
│E...T...T..S║
│........T...║
■════════════■