env: 2
name: Level 10
filler: 1|3|7|0
---
┌──────╖
│.....H║
│..TT..║
│..ST..║
│.TTT..║
│V.....║
│.....E║
╘══════╝