■────────────────────────■
│E..T■...T■......■..T.■..║
│TT..T.T..■....T......■..║
│....■....■......■TT..T..║
│..■T■.T..■..T...■....T..║
│....T.T..■......■..T....║
│....■.■..■......■T..T...║
│■T■...■..■...T..■.....T.║
│....T■...■T.....■....T.T║
│....■...........■TTT...G║
■════════════════════════■