env: 2
---
X──────────────────X
│E..V.......V......║
│...T.......T......║
│H....T...T...T...S║
│.......T.......T..║
│.......V.......V..║
X══════════════════X