env: 2
filler: 0|1|3|0
filler: 1|12|5|180

---
■─────────────■
│.............║
│.............║
│C.E...T.....S║
│.............║
│......B......║
■═════════════■