env: 2
---
■─────────■
│~~~~~~~~~║
│~E.....S~║
│~~~~~~~~~║
│~~B~V~~~G║
■═════════■