env: 2
---
■───────■
│H..V...║
│.......║
│E.....S║
│.......║
■═══════■