env: 2
---
XXXXXXXXXXXXXXXXXXXXXX
X..X......X..........X
X....E.X..X....T.....X
X..TXX..XXXX..ST.....X
X.....X...X..TTT.....X
XX.XXXXXXXXX.XXXXX.XXX
X.........X...XX.....X
X.....T...X.X.T...T..X
X...T.....XT....TTXXTX
X.T.....X.X..........X
XXXXXX.XXXXXXXXXXX.XXX
X.........X..........X
X.......T.X..........X
X...X.T.....TX.......X
X.........X..........X
XXXXXXXXXXXXXXXXXXXXXX