env: 2
name: Level 13 - Tidepod crossroad
filler: 2|12|2|0
filler: 0|3|2|0
---
┌──────────────────╖
│E~.V.......V.....~║
│~~.T.......T....~~║
│H....T.B.T...T..~S║
│.......T.......T~~║
│.......V.......V.~║
╘══════════════════╝