env: 2
---
XXXXXXXXXXXX
X......T...X
X.XXXX.X...X
X....XX..XXX
X...TTT...TX
X...TETST..X
X.X...TTTX.X
X.X.XXX....X
X.X...X.X..X
X.......X..X
XXXXXXXXXXXX