env: 2
filler: 0|1|2|0
filler: 1|12|6|0
---
┌─────────────╖
│.............║
│.............║
│C.E...T.....S║
│.............║
│......B......║
╘═════════════╝