env: 2
---
■──────■
│.....H║
│..TT..║
│..ST..║
│.TTT..║
│V.....║
│.....E║
■══════■