env: 2
---
XXXXXXXXXXXXXXXXXXXX
XS.T.........XXXXXXX
XT.TTTTTTTTT.XXXXXXX
XT.T.......T.XXXXXXX
X..T.TTTTT.T.XXXXXXX
X.TT.T...T.T.XXXXXXX
X.TT.TET.T.T.XXXXXXX
X..T.TTT.T.T.XXXXXXX
XT.T.....T.T.XXXXXXX
XT.TTTTTTT.T.XXXXXXX
X..........T.XXXXXXX
X.TTTTTTTTTT.XXXXXXX
X............XXXXXXX
XXXXXXXXXXXXXXXXXXXX
