env: 2
---
■──────────■
│......T...║
│.■■■■.■...║
│....■■..TT║
│...TTT...T║
│...TETST..║
│.■...TTT■.║
│.■.■■■....║
│.■...■.■..║
│.......■..║
■══════════■