env: 4
---
■──────────────────■
│....■........T....║
│..T.■............T║
│....■H......T.....║
│.■..■..■■■■■■■■■■.║
│E■..■...........■S║
│.■...T....TTTTTT■.║
│■■■■H.............║
│...........TT.TTTT║
│......V..........H║
■══════════════════■