env: 2
---
XXXXXXXXXXXXXXXXXXXXXXXXX
X.........T..X.......XTSX
X.X.......X..X.......X..X
X.X.......X..X...T...X.TX
XEX.......T..X...X...X..X
X.X..............X...X..X
X....X.XXX.......X...X..X
X.......TX.......X......X
XXXXXXXXXXXXXXXXXXXXXXXXX