env: 1
filler: 0|1|2|0
filler: 1|12|6|0
---
┌───────╖ ┌─────╖
│...G...║ │T.T.T║
│.......X─X.....║
│..E.....1....S.║
│.......X═X.....║
│.2..3..║ │T.T.T║
╘═══════╝ ╘═════╝