env: 1
name: Final level - Good luck!
---
┌──────────────────╖
│V.V..■TG.........H║
│...T.TTTTTTTTTT...║
│T■.T.T........T...║
│...T.T.TTTT.■.T..H║
│...T.T.TE.T...T...║
│.TTT.T.TT.T.■BT..H║
│...T.T....T...T...║
│...T.TTTTTT.■.T..H║
│■T.T..........T...║
│...TTT......■.T..H║
│.TTTTTTTTTTTTTT...║
│..................║
╘══════════════════╝