XXXXXXXXXXX
X~~~~~~~~~X
X~E.....S~X
X~~~~~~~~~X
XXXXXXXXXXX