env: 2
filler: 1|13|12|180
filler: 3|1|1|0
filler: 0|10|1|0
---
┌──────────────╖
│STT...........║
│..TTTTTTTTTTT.║
│T.T.........T.║
│..T..TTTTT..T.║
│.T.T.T...T..T.║
│.T.T.TET.T..T.║
│...T.TTT.T..T.║
│T..T.....T..T.║
│T..TTTTTTT..T.║
│T...........T.║
│..TTTTTTTTTTT.║
│..............║
╘══════════════╝