env: 2
name: Level 6 - Rooms
filler: 2|7|13|180
---
┌──────────────────╖
│.■......■.........║
│...E.■..■....T....║
│.T■■..■■■■..ST....║
│....■...■..TTT....║
│.■■■■■■■■■.■■■■.■■║
│........■...■■....║
│....T...■.■.T..T..║
│..T.....■T....T■■T║
│T.....■.■.........║
│■■■■.■■■■■■■■■■.■■║
│........■.........║
│..■.T.....T■......║
╘══════════════════╝