env: 1
filler: 4|6|2|180
filler: 2|12|5|90
---
┌────────────╖
│E..........T║
│.■H..T....■.║
│..........V.║
│...■H...■...║
│...V..T.....║
│....T..T....║
│....TS.T....║
│.....T..V...║
│...■...H■...║
│.V..........║
│.■.......H■.║
│T..........C║
╘════════════╝