env: 2
---
■─────────■
│~~~~~~~~~║
│~E.....S~║
│~~~~~~~~~║
│~~~~~V~~~║
■═════════■