env: 1
name: Tutorial
filler: 0|1|2|0
filler: 1|12|6|0
filler: 6|11|0|0
---
┌───────╖ ┌─────╖
│#######║ │T.T.T║
│.......X─X..###║
│..E.....1...#S#║
│.......X═X..###║
│#######║ │T.T.T║
╘═══════╝ ╘═════╝