env: 2
---
■──────────■
│E.......T.║
│H.........║
│...T..T...║
│H.........║
│........TS║
■══════════■