env: 1
name: Level 3 - Stairs
filler: 1|17|2|180
filler: 2|5|10|180
---
┌──────────────────╖
│..■.....■....■####║
│...■.......T..■###║
│...■.■..■B■....■##║
│##...■..■■■..T..■#║
│E#.T....■T..TTT..S║
│##...■..■■■..T..■#║
│.....■..■.■....■##║
│...■.......T..■###║
│..■.....■....■####║
╘══════════════════╝