env: 1
name: Level 2
filler: 4|12|2|180
filler: 5|3|8|180
---
┌──────────────────╖
│......■.....T..T■.║
│.■..■........T....║
│.■...■...T.....■.T║
│E■..........T..T.S║
│.■....■........■.T║
│.■...■■..T.......■║
│...T..■........T..║
╘══════════════════╝