env: 2
---
■──────────────────■
│E..T■...T■■..T.■..║
│TT..T.T..■.....■..║
│....■....■T....T..║
│..■T■.T..■..■..T..║
│....T.T..■...T....║
│....■.■..■TT.■T...║
│■T■...■..■T..T..T.║
│....T■.......■T..T║
│......T...■TTT.T.S║
■══════════════════■