env: 2
filler: 0|1|2|0
filler: 1|12|6|0
---
┌─────────────╖
│.............║
│.............║
│1.E...T.....S║
│.............║
│......B......║
╘═════════════╝