env: 2
name: Level 12 - Two ways
filler: 1|3|2|180
filler: 3|9|10|180
---
┌──────────────────╖
│....■........T....║
│..T.■............T║
│....■H......T.....║
│~■..■..■■■■■■■■■■~║
│E■..■...........■S║
│~■...T....TTTTTT■~║
│■■■■H.............║
│...........TT.TTTT║
│......V..........H║
╘══════════════════╝