env: 1
filler: 3|5|2|0
filler: 2|10|4|180
---
┌────────────╖
│....T.......║
│E...T...T..S║
│........T...║
╘════════════╝