env: 1
name: Level 5 - Going outside
filler: 2|10|2|0
filler: 3|3|10|180
---
┌──────────────────╖
│.....■.......T■■■2║
│.■■..■.....■..■...║
│..T..■....■T■.■.TT║
│..T.■■.....■....TT║
│.ET......■........║
│..T.■■..■T■...■■■.║
│..T..■...■....■T..║
│.■■..■.....T..■.ST║
│.....■......T...TT║
╘══════════════════╝