env: 1
---
■────────────■
│E..........T║
│.■H..T....■.║
│..........V.║
│...■H...■...║
│...V..T.....║
│....T..T....║
│....TG.T....║
│.....T..V...║
│...■...H■...║
│.V..........║
│.■.......H■.║
│T..........C║
■════════════■