env: 2
filler: 4|5|2|180
filler: 0|5|6|180
---
┌──────────╖
│E.......T.║
│H.........║
│...T..T...║
│H.........║
│........TS║
╘══════════╝