env: 2
filler: 4|6|9|180
filler: 2|6|1|0
---
■──────────────────■
│..■.....■....■....║
│...■.......T..■...║
│...■.■..■.■....■..║
│.....■..■■■..T..■.║
│E..T....■T..TTT..S║
│.....■..■■■..T..■.║
│.....■..■.■....■..║
│...■.......T..■...║
│..■.....■....■....║
■══════════════════■