env: 2
---
┌──────────────────╖
│E..V.......V......║
│...T.......T......║
│H....T...T...T...S║
│.......T.......T..║
│.......V.......V..║
╘══════════════════╝