env: 2
---
■──────────────────■
│.....■.......T■■■C║
│.■■..■.....■..■...║
│..T..■....■T■.■.TT║
│..T.■■.....■....TT║
│.ET......■........║
│..T.■■..■T■...■■■.║
│..T..■...■....■T..║
│.■■..■.....T..■.ST║
│.....■......T...TT║
■══════════════════■