 XXXXXXXXXXXX
XX...T......XX
XE...T...T..SX
XX.......T..XX
 XXXXXXXXXXXX