XXXXXXSXXXXX
X...T......X
X...T...T..E
X.......T..X
XXXXXXXXXXXX