XXXXXXXXXXX
X......S..X
X.E.......XX
X.........X
XXXXXXXXXXX