XXXXXXXXXXXXXX
XS.T.........X
XT.TTTTTTTTT.X
XT.T.......T.X
X..T.TTTTT.T.X
X.TT.T...T.T.X
X.TT.TET.T.T.X
X..T.TTT.T.T.X
XT.T.....T.T.X
XT.TTTTTTT.T.X
X..........T.X
X.TTTTTTTTTT.X
X............X
XXXXXXXXXXXXXX